16,room16,,,,,,,,,,
1,,,,,,,,,,,
0,2,0,1,,,,,,,,
0,0,0,0,0,0,0,0,0,0,0,0
0,10,10,10,0,0,0,0,10,10,10,0
0,10,0,0,0,0,0,0,0,0,10,0
0,10,0,10,10,10,10,10,10,0,10,0
0,10,0,0,0,0,0,0,0,0,10,0
0,10,10,10,0,0,0,0,10,10,10,0
0,0,0,0,0,0,0,0,0,0,0,0
1
6
1
2,2,2
4,7,8
2,2,0