12,room12,,,,,,,,,,
1,,,,,,,,,,,
2,0,0,1,,,,,,,,
10,10,10,10,10,0,0,10,10,10,10,10
10,0,0,0,10,0,0,0,0,10,0,10
10,0,10,0,10,0,10,10,0,10,0,10
0,0,10,0,10,0,0,10,0,10,0,0
10,0,10,0,10,10,0,10,0,10,0,10
10,0,10,0,0,0,0,10,0,0,0,10
10,10,10,10,10,0,0,10,10,10,10,10
1
10
1
4,4,4
1,8,10
1,4,1