6,room6,,,,,,,,,,
1,,,,,,,,,,,
0,1,0,0,,,,,,,,
0,0,0,0,0,0,0,0,0,0,0,0
0,0,1,0,0,0,0,0,0,1,0,0
0,0,0,0,0,0,0,0,0,0,0,0
0,0,0,0,0,0,0,0,0,0,0,0
0,0,0,0,0,0,0,0,0,0,0,0
0,0,1,0,0,0,0,0,0,1,0,0
0,0,0,0,0,0,0,0,0,0,0,0
6
10
3
0,0,0,0,0,0,0,0
3,6,6,8,8,10,10,11
0,2,4,2,4,1,5,3