9,room9,,,,,,,,,,
1,,,,,,,,,,,
1,1,2,4,,,,,,,,
0,0,0,0,0,0,0,0,0,0,0,0
0,1,1,0,0,0,0,0,0,1,1,0
0,0,0,0,0,0,0,0,0,0,0,0
0,0,0,0,0,1,1,0,0,0,0,0
0,0,0,0,0,0,0,0,0,0,0,0
0,1,1,0,0,0,0,0,0,1,1,0
0,0,0,0,0,0,0,0,0,0,0,0
5
10
3
1,1,1,1,1
3,4,8,8,11
5,0,3,5,2