0,room0,,,,,,,,,,
1,,,,,,,,,,,
2,1,1,1,,,,,,,,
0,0,0,0,0,0,0,0,0,0,0,0
0,2,0,0,2,0,0,2,0,0,2,0
0,0,0,0,0,0,0,0,0,0,0,0
0,2,0,0,2,0,0,2,0,0,2,0
0,0,0,0,0,5,5,0,0,0,0,0
0,2,0,5,2,5,5,2,5,0,2,0
0,0,0,5,5,5,5,5,5,0,0,0
0,7
2,2
2,1
