13,room13,,,,,,,,,,
1,,,,,,,,,,,
0,0,3,1,,,,,,,,
0,0,0,0,0,0,0,1,1,1,1,1
0,0,0,0,0,0,0,0,0,1,1,1
0,0,0,0,0,0,0,0,0,0,1,1
0,0,0,0,0,0,0,0,0,0,0,0
0,0,0,0,0,0,0,0,0,0,1,1
0,0,0,0,0,0,0,0,0,1,1,1
0,0,0,0,0,0,0,1,1,1,1,1
11
11
3
5
9
2