17,room17,,,,,,,,,,
1,,,,,,,,,,,
1,0,0,0,,,,,,,,
9,9,9,9,9,9,9,9,9,9,9,9
9,1,1,0,0,0,0,0,0,1,1,9
9,0,0,0,0,0,0,0,0,0,0,9
9,0,0,0,0,1,1,0,0,0,0,9
9,0,0,0,0,0,0,0,0,0,0,9
9,1,1,0,0,0,0,0,0,1,1,9
9,9,9,9,9,9,9,9,9,9,9,9
1
6
1
2,2,2
4,7,8
2,2,0
